Compound	Target	Function	Pathway
ADAM17	ADAM17	Differentiation	EMT/migration
AKT	"AKT1;AKT2;AKT3"	Oncogenic signal	AKT/PI3K
AKT_1	AKT*	Oncogenic signal	AKT/PI3K
AKT_PIK3C	"AKT*;PIK3C*"	Oncogenic signal	AKT/PI3K
AKT_SGK	"AKT*;SGK*"	Oncogenic signal	AKT/PI3K
ALK	ALK	Oncogenic signal	AKT/PI3K
ALK_2	ALK	Oncogenic signal	RTK
ALK_IGFR	"ALK;IGF*R"	Oncogenic signal	AKT/PI3K
AR	AR	Oncogenic signal	Hormonal
AR_1	AR	Oncogenic signal	Hormonal
ATM	ATM	DNA repair	DNA Damage Response
ATR_1	ATR	DNA repair	DNA Damage Response
ATR_2	ATR	DNA repair	DNA Damage Response
ATR_3	ATR	DNA repair	DNA Damage Response
ATR_4	ATR	DNA repair	DNA Damage Response
Azacytidine	Methylation	Differentiation	Epigenetic
BCL2	BCL2	Cell death	Apoptosis
BCL2_2	BCL2	Cell death	Apoptosis
BCL2_3	BCL2	Cell death	Apoptosis
BCL2_BCL2L1	"BCL2;BCL2L1"	Cell death	Apoptosis
BCL2_BCL2L1_BCL2L2	"BCL2;BCL2L1;BCL2L2"	Cell death	Apoptosis
BCL2L1	BCL2L1	Cell death	Apoptosis
BIRC5	BIRC5	Cell death	Apoptosis
BRAF_2	BRAF	Oncogenic signal	MAPK
BRAF_M	BRAF_mut	Oncogenic signal	MAPK
BRAF_M2	BRAF_V600E	Oncogenic signal	MAPK
BRAF_VEGFR2	"BRAF;VEGFR2"	Oncogenic signal	MAPK
Carboplatin	DNA	DNA repair	Chemo
CarboTaxol	DNA	DNA repair	Chemo
CD19	CD19 antibody	Differentiation	EMT/migration
CHEK1	CHEK1	DNA repair	DNA Damage Response
Chloroquine	Thiamine	other	other
Cisplatin	DNA	DNA repair	Chemo
CSNK2A1	CSNK2A1	Oncogenic signal	STK
CSNK2A1_2	CSNK2A1	Oncogenic signal	STK
Docetaxel	"TUBB1;BCL2;MAP2;MAP4;MAPT;NR1I2"	DNA repair	Chemo
Doxorubicin	"TOP*;DNMT1"	DNA repair	Chemo
EG5	KIF11	Differentiation	EMT/migration
EGFR	EGFR	Oncogenic signal	RTK
EGFR_2	EGFR	Oncogenic signal	RTK
ERBB	"EGFR;ERBB*"	Oncogenic signal	RTK
ESR1	ESR1	Oncogenic signal	Hormonal
ESR1_1	ESR1	Oncogenic signal	Hormonal
ESR1_2	ESR1	Oncogenic signal	Hormonal
ESR1_3	ESR1	Oncogenic signal	Hormonal
FASN	FASN	Metabolism	Metabolism
FGFR	"FGFR1;FGFR2;FGFR3"	Oncogenic signal	RTK
FGFR4	FGFR4	Oncogenic signal	RTK
FNTA_FNTB	"FNTA;FNTB"	Metabolism	Metabolism
FOLFIRI	DNA	DNA repair	Chemo
FOLFOX	DNA	DNA repair	Chemo
Gemcitabine	"DNA;RRM1;TYMS;CMPK1"	Cell death	Chemo
gSEC	Gamma secretase	Differentiation	EMT/migration
HDAC_4	HDAC*	Differentiation	Epigenetic
HDAC1_HDAC3	"HDAC1;HDAC3"	Differentiation	Epigenetic
HSP90	HSP90AA1	Cell death	Apoptosis
IAP	"NIAP;XIAP;BIRC2;BIRC3"	Cell death	Apoptosis
IAP_2	"NIAP;XIAP;BIRC2;BIRC3"	Cell death	Apoptosis
IGFR_2	IGF*R	Oncogenic signal	RTK
IGFR_3	IGF*R	Oncogenic signal	RTK
IGFR_4	IGF*R	Oncogenic signal	RTK
IKBK	"CHUK;IKBK*"	Cell death	Apoptosis
JAK	"JAK1;JAK2"	Oncogenic signal	Cell Cycle
MAP2K	"MAP2K1;MAP2K2"	Oncogenic signal	MAPK
MAP2K_1	"MAP2K1;MAP2K2"	Oncogenic signal	MAPK
MAP2K_2	MAP2K*	Oncogenic signal	MAPK
MAP2K_3	MAP2K*	Oncogenic signal	MAPK
MAP2K_RAF	"MAP2K1;MAP2K2;RAF1;BRAF"	Oncogenic signal	MAPK
MET	cMET	Oncogenic signal	RTK
MET_2	MET	Oncogenic signal	RTK
MET_ALK	"cMET;ALK"	Oncogenic signal	RTK
MTOR	MTOR	Oncogenic signal	AKT/PI3K
MTOR_1	MTOR	Oncogenic signal	AKT/PI3K
MTOR_2	MTOR	Oncogenic signal	AKT/PI3K
MTOR_3	MTOR	Oncogenic signal	AKT/PI3K
MTOR_4	MTOR	Oncogenic signal	AKT/PI3K
MTOR_5	MTOR	Oncogenic signal	AKT/PI3K
NAE	"NAE1;NAE2"	Metabolism	Metabolism
Oxaliplatin	DNA	DNA repair	Chemo
PARP1	PARP1	DNA repair	DNA Damage Response
PARP1_2	PARP1	DNA repair	DNA Damage Response
PDGFR_Ab	PDGFRA	Oncogenic signal	RTK
PI3KCD	PIK3CD	Oncogenic signal	AKT/PI3K
PIK3C	PIK3C*	Oncogenic signal	AKT/PI3K
PIK3C_2	PIK3C*	Oncogenic signal	AKT/PI3K
PIK3C_MTOR	"PIK3C*;MTOR"	Oncogenic signal	AKT/PI3K
PIK3C_MTOR_2	"PIK3C*;MTOR"	Oncogenic signal	AKT/PI3K
PIK3CA_2	PIK3CA	Oncogenic signal	AKT/PI3K
PIK3CA_3	PIK3CA	Oncogenic signal	AKT/PI3K
PIK3CA_4	PIK3CA	Oncogenic signal	AKT/PI3K
PIK3CB	PIK3CB	Oncogenic signal	AKT/PI3K
PIK3CB_PIK3CD	"PIK3CB;PIK3CD"	Oncogenic signal	AKT/PI3K
PIM1	PIM1	Oncogenic signal	STK
PIP5K1	PIP5K1*	Metabolism	Metabolism
PRKC	PRKC*	Differentiation	EMT/migration
PRKDC_2	PRKDC	DNA repair	DNA Damage Response
Proteasome	Proteasome	Cell death	Apoptosis
Proteasome_2	Proteasome	Cell death	Apoptosis
PTK2	PTK2*	Differentiation	EMT/migration
PTK2_2	PTK2*	Differentiation	EMT/migration
SLC16A4	"SLC16A3;SLC16A4"	Metabolism	Metabolism
SN38	"TOP1;TOP2*"	DNA repair	Chemo
SRC	SRC	Oncogenic signal	RTK
SYK	SYK	Oncogenic signal	Cell Cycle
TKI	"KDR;EGFR;RET"	Oncogenic signal	RTK
TKI_2	"VEGFR2;TIE2"	Differentiation	EMT/migration
TNF	TNFA	Cell death	Apoptosis
TNFSF10	TNFSF10	Cell death	Apoptosis
TNKS_PARP6	"TNKS;PARP6"	Oncogenic signal	Cell Cycle
TOP2	"TOP2*;PRKDC"	DNA repair	DNA Damage Response
TOP2_2	TOP2*	DNA repair	Chemo
Topotecan	"TOP1;TOP1MT;DNA"	DNA repair	Chemo
TTK	TTK	Oncogenic signal	STK
TYMS	TYMS	DNA repair	Cell Cycle
VEGF	"KDR;FLT1;FLT4"	Differentiation	EMT/migration
Vinorelbine	"microtubule;TUBB"	DNA repair	Chemo
WEE1	WEE1	DNA repair	DNA Damage Response
WNT	"WNT*;TNKS"	Differentiation	EMT/migration